#domain
hospital
#levelname
SAExample
#colors
red: 0, B, A
#initial
++++++++++++
+  A    0+ +
+ ++++++++ +
+          +
+B++++++++ +
+ +        +
++++++++++++
#goal
++++++++++++
+        + +
+ ++++++++ +
+          +
+ ++++++++ +
+B+A       +
++++++++++++
#end
