#domain
hospital
#levelname
MAEasy
#colors
red: 0, A
green: 1, B
#initial
++++++++
+   0+ +
+ ++++A+
+      +
+      +
+B++++ +
+ +1   +
++++++++
#goal
++++++++
+    +A+
+ ++++ +
+      +
+      +
+ ++++ +
+B+    +
++++++++
#end
