#domain
hospital
#levelname
MAExample
#colors
red: 0, A
green: 1, B
#initial
++++++++++++
+      B0+ +
+ ++++++++A+
+          +
+      B   +
+  +++++++ +
+  +1      +
++++++++++++
#goal
++++++++++++
+        +A+
+ ++++++++ +
+          +
+          +
+  +++++++ +
+BB+       +
++++++++++++
#end
