#domain
hospital
#levelname
SAthomasAppartment
#colors
blue: 0, A, B, C, D, E, F, G, H, I, J, K, L, M, N, O
#initial
                   +++++++++
                   +D      +
++++++++++++++++++++       +
+   C  +     +     +   E   + 
+ A    +     +     +       +
+      +     +     +F      +
+   B  +     +     +       +
+                  +      G+
+++++++++O+ +++++++++  +++ +
+        N+          KL +  +
+        M+     I       +  +
+                   0   +  +
+            J          +  +
+         +             +  +
+         +      H      +  +
+         +             +  +
++++++++++++++++++++++++++++
#goal
                   +++++++++
                   +   DEFG+
++++++++++++++++++++       +
+      +     +MNO  +       + 
+      +     +     +       +
+      +     +     +       +
+      +     +     +       +
+                  +       +
+++++++++ + +++++++++  +++ +
+         +             +  +
+         +             +  +
+                       +  +
+                       +  +
+         +             +C +
+         +             +B +
+HIJKL    +             +A +
++++++++++++++++++++++++++++
#end