#domain
hospital
#levelname
SAExample
#colors
red: 0, A
#initial
++++++++++++
+0      A+ +
+ ++++++++ +
+          +
+ ++++++++ +
+ +        +
++++++++++++
#goal
++++++++++++
+        +A+
+ ++++++++ +
+          +
+ ++++++++ +
+ +        +
++++++++++++
#end
