#domain
hospital
#levelname
MABoxAgents
#colors
blue: 0, B, O, X, M, A, S
red: 1, E, G, N, T, L
green: 2, H, Q, W, D, R
#initial
++++++++++++++++++++
+     ML++D HELLQ  +
+ ++++++++WQRLD    +
+ + A  +   +++++++++
+   ++ +       +++ +
++++++ +++++++     +
+           + + ++++
+ BOXAGENTS + +    +
+           +      +
++++        + ++++++
+           +     ++
+ + + + + +++++++ ++
+0+ +1+ + +2       +
++++++++++++++++++++
#goal
++++++++++++++++++++
+       ++         +
+ ++++++++         +
+ +    +   +++++++++
+   ++ +       +++ +
++++++ +++++++     +
+           + + ++++
+   AGENT   + +    +
+           +  HQWD+
++++        + ++++++
+           +     ++
+ + + + + +++++++ ++
+X+M+A+S+L+        +
++++++++++++++++++++
#end
