#domain
hospital
#levelname
SAaiaioh
#colors
blue: 0, A
#initial
+++++++++
+A      +
+       +
+       +
+    ++++
+0   +A +
+       +
+++++++++
#goal
+++++++++
+       +
+       +
+      A+
+    ++++
+    +  +
+       +
+++++++++
#end
