#domain
hospital
#levelname
SABaguettes
#colors
red: 0, A
#initial
++++++++++++++++++++++++++++++++++++++++++++++++
+0A                                            +
+ A                                            +
+ A                                            +
+ A                                            +
+ A                                            +
+ A                                            +
+ A                                            +
+ A                                            +
+ A                                            +
+ A                                            +
+ A                                            +
+ A                                            +
+ A                                            +
+ A                                            +
+ A                                            +
+ A                                            +
+ A                                            +
+ A                                            +
+ A                                            +
+ A                                            +
+ A                                            +
+ A                                            +
+ A                                            +
+ A                                            +
+ A                                            +
+ A                                            +
+ A                                            +
+ A                                            +
+ A                                            +
+ A                                            +
+ A                                            +
+ A                                            +
+ A                                            +
+ A                                            +
+ A                                            +
+ A                                            +
+ A                                            +
+ A                                            +
+ A                                            +
+ A                                            +
+ A                                            +
+ A                                            +
+ A                                            +
+ A                                            +
+ A                                            +
+ A                                            +
+ A                                            +
+ A                                            +
++++++++++++++++++++++++++++++++++++++++++++++++
#goal
++++++++++++++++++++++++++++++++++++++++++++++++
+0                                            A+
+                                             A+
+                                             A+
+                                             A+
+                                             A+
+                                             A+
+                                             A+
+                                             A+
+                                             A+
+                                             A+
+                                             A+
+                                             A+
+                                             A+
+                                             A+
+                                             A+
+                                             A+
+                                             A+
+                                             A+
+                                             A+
+                                             A+
+                                             A+
+                                             A+
+                                             A+
+                                             A+
+                                             A+
+                                             A+
+                                             A+
+                                             A+
+                                             A+
+                                             A+
+                                             A+
+                                             A+
+                                             A+
+                                             A+
+                                             A+
+                                             A+
+                                             A+
+                                             A+
+                                             A+
+                                             A+
+                                             A+
+                                             A+
+                                             A+
+                                             A+
+                                             A+
+                                             A+
+                                             A+
+                                             A+
++++++++++++++++++++++++++++++++++++++++++++++++
#end
