#domain
hospital
#levelname
SAFPHPOP
#colors
blue: 0, A, B
#initial
++++++++++++++++++++++++++++++++++++++++++++++++++
+0A                                             B+
+ A                                             B+
+ A                                             B+
+ A                                             B+
+ A                                             B+
+ A                                             B+
+ A                                             B+
+ A                                             B+
+ A                                             B+
+ A                                             B+
+ A                                             B+
+ A                                             B+
+ A                                             B+
+ A                                             B+
+ A                                             B+
+ A                                             B+
+ A                                             B+
+ A                                             B+
+ A                                             B+
+ A                                             B+
+ A                                             B+
+ A                                             B+
+ A                                             B+
+ A                                             B+
+ A                                             B+
+ A                                             B+
+ A                                             B+
+ A                                             B+
+ A                                             B+
+ A                                             B+
+ A                                             B+
+ A                                             B+
+ A                                             B+
+ A                                             B+
+ A                                             B+
+ A                                             B+
+ A                                             B+
+ A                                             B+
+ A                                             B+
+ A                                             B+
+ A                                             B+
+ A                                             B+
+ A                                             B+
+ A                                             B+
+ A                                             B+
+ A                                             B+
+ A                                             B+
+ A                                             B+
++++++++++++++++++++++++++++++++++++++++++++++++++
#goal
++++++++++++++++++++++++++++++++++++++++++++++++++
+B                                              A+
+B                                              A+
+B                                              A+
+B                                              A+
+B                                              A+
+B                                              A+
+B                                              A+
+B                                              A+
+B                                              A+
+B                                              A+
+B                                              A+
+B                                              A+
+B                                              A+
+B                                              A+
+B                                              A+
+B                                              A+
+B                                              A+
+B                                              A+
+B                                              A+
+B                                              A+
+B                                              A+
+B                                              A+
+B                                              A+
+B                                              A+
+B                                              A+
+B                                              A+
+B                                              A+
+B                                              A+
+B                                              A+
+B                                              A+
+B                                              A+
+B                                              A+
+B                                              A+
+B                                              A+
+B                                              A+
+B                                              A+
+B                                              A+
+B                                              A+
+B                                              A+
+B                                              A+
+B                                              A+
+B                                              A+
+B                                              A+
+B                                              A+
+B                                              A+
+B                                              A+
+B                                              A+
+B                                              A+
++++++++++++++++++++++++++++++++++++++++++++++++++
#end
